32 32
_++++++_________________________
______+_________________________
______+_________________________
______+++++++__+++++_+__________
______________________+_________
______________________+_________
___++++++++___________+_________
___+________+_________+_________
___+________+_______+++_________
___+________+___++++____________
___+__________+++_______________
___+____________________________
________________________________
___+____________________________
___+++++___+____________________
___________+____________________
___________++_+_________________
_________________+______________
_________________+______________
_________________++_____________
___________________++___________
_____________________++_________
_______________________+________
_______________________+________
____________________++++________
________________________________
________________________________
________________________________
________________________________
________________________________
________________________________
________________________________