32 32
_++++++++++_____________________
__________+_____________________
__________+_____________________
__________+_____________________
__________+___0+________________
++++______+___0_________0+++++++
___+______+___0_________+_______
___+______+___+_________+_______
___+______+0+00_________+_______
___+______+0____________+_______
___++++++++0____________+_______
___________+______0+++++0_______
___________000+0__+_____________
_______________0__+_____________
_______________+__+_____________
___________0+000__+_____________
___________0______+_____________
___________+______+_____________
_______0+000______0_____________
_______0__________0_____________
_______0__________+_____________
_______+__________+_____________
____0+00__________+_____________
____0_____________+_____________
____+_____________+_____________
____+_____________+_____________
____+_____________0_____________
____+00++++0++++++0_____________
________________________________
________________________________
________________________________
________________________________